1111111111111111111111111111111111111111
1110001110001110001110001110001110001111
1E00V00000V00000V00000V00000V00000V00001
1111000110001110001110001110001110001101
10C1111111111111111111111111111111111101
1000000000000V00000000000000000000000001
10C1111100000111000111001110001111111111
1111000100000100000111001110001C101101C1
10000000V000C101110CV000CV00001001001101
1000111100000001VV1111110000000000000001
1011111111111111111111111111111111111111
10000000000000000010C1C1101C01C0111110C1
10001100011000010101V101100V001001010011
1000110V01100000010100010110101100010011
10000C111C000000000000110100101V01000101
1V0011VVV1100000010101000010110101001011
1000111111100010000000001000000010001011
1000110V0110000001101010001V101000100011
100000000000000010101V101101001C101010P1
1111111111111111111111111111111111111111