1111111111111111111111111111111111111111
1E00000000000000000000000000000000000001
1000000000000000000000000000000000000001
10000000000000000000V0000000000000000001
10000000V0000000V00000000000000000000001
10000000000000000000000000000V0000000001
1000000000000000000000000000000000000001
100000000000000V000000000000000000000001
100000000V000000000000000000000000000001
1000000000000000000000000000V00000000001
1000000000000000000000000000000000000001
100000000000000000000000V000000000000001
1000000000000000000000000000000000000001
1000000000000000000000000000000000000001
1000V00000V00000V00000V00000V00000000001
1000000000000000000000000000000000000001
1000000000000000V00000000000000000000001
100000000000V00000000000V000000000000001
1000000000000C000000000000000000000000P1
1111111111111111111111111111111111111111